11111111111111
10000000000001
100P00C000C001
10000000000001
10000000E00001
101C0000000001
11111111111111
